111111111111111
1000CCC0CCC0001
100CX00C00XC001
100C0000000C001
100C0000000C001
1000C000P0C0001
10000C000C00001
100X00C0C00X001
1000000C00000E1
111111111111111